Pr|PrimaryColor|around
e|extends|around
B|Blue|around
o|object|around
P|PrimaryColor|around
exte|extends|around
value|valueOf|metals
Pri|PrimaryColor|metals
Prima|PrimaryColor|metals
Pr|PrimaryColor|metals
Primary|PrimaryColor|metals
Ac|Action|around
ex|extends|around
wi|width|metals
small|smallRectangle|metals
wi|width = |metals
sma|smallRectangle|metals
he|height = |metals
Re|Rectangle|metals
he|height|metals
fac|facade2|metals
is|isSunny|metals
pu|public|around
Ar|Array|metals
shou|shoulders|around
sti|stick|around
prin|print|pyright
sa|saveAsTable|around
comenta|comentario|around
p|prod1|around
pr|prod1|around
fun|funcion|around
t|tmp_h05_wc|around
na|name|around
l|latest|coc-dot-complete
|nginx|coc-dot-complete
d|docker_image|around
n|nginx|around
d|docker|around
re|resource|around
n|name|around
tr|true|around
sq|sql|coc-dot-complete
spa|spark|around
mer|mergeSchema|around
mas|master|around
|create_database.sql|file
volum|volumes|around
|bin|file
gsl|gsl_sf_bessel|around
note|notebook_name|pyright
github_|github_user|around
noteb|notebook_name|pyright
hello|hello_airflow|around
githu|github_user|pyright
classif|classification_products_dag|around
ho|homebrew|file
exp|export|around